--------------------------------------------------------------------------------
---------------------------------------------------B----------------------------
--------------------------------------------BBB--------B------------------------
----------------------------B-B---------B------------------------BB----------BBB
--------------------------B----------------------------------BB-----------B-----
------------------------B-------B---B-------------------------------------------
----------------------B------------------------------------B-------------B-------
--------------------B-------------------------B----B----------------------------
-------------------B----------------------B--------------B------------B---------
-----------------BB-------------------BB----------------BBB---------B-----------
--h-----------BBB------------------B--------------------BBB---------B-----------
--------------------------------------------------------------------------------